98
34
0 0 0 0 0 0 0 0 0 0 0 0 0 0 0 0 0 0 0 0 0 0 0 0 0 0 0 0 0 0 0 0 0 0 0 0 0 0 0 0 0 0 0 0 0 0 0 0 0 0 0 0 0 0 0 0 0 0 0 0 0 0 0 0 0 0 0 0 0 0 0 0 0 0 0 0 0 0 0 0 0 0 0 0 0 0 0 0 0 0 0 0 0 0 0 0 0 0 
0 0 0 0 0 0 0 0 0 0 0 0 0 0 0 0 0 0 0 0 0 0 0 0 0 0 0 0 0 0 0 0 0 0 0 0 0 0 0 0 0 0 0 0 0 0 0 0 0 0 0 0 0 0 0 0 0 0 0 0 0 0 0 0 0 0 0 0 0 0 0 0 0 0 0 0 0 0 0 0 0 0 0 0 0 0 0 0 0 0 0 0 0 0 0 0 0 0 
0 0 0 0 0 0 0 0 0 0 0 0 0 0 0 0 0 0 0 0 0 0 0 0 0 0 0 0 0 0 0 0 0 0 0 0 0 0 0 0 0 0 0 0 0 0 0 0 0 0 0 0 0 0 0 0 0 0 0 0 0 0 0 0 0 0 0 0 0 0 0 0 0 0 0 0 0 0 0 0 0 0 0 0 0 0 0 0 0 0 0 0 0 0 0 0 0 0 
0 0 0 0 0 0 0 0 0 0 0 0 0 0 0 0 0 0 0 0 0 0 0 0 0 0 0 0 0 0 0 0 0 0 0 0 0 0 0 0 0 0 0 0 0 0 0 0 0 0 0 0 0 0 0 0 0 0 0 0 0 0 0 0 0 0 0 0 0 0 0 0 0 0 0 0 0 0 0 0 0 0 0 0 0 0 0 0 0 0 0 0 0 0 0 0 0 0 
0 0 0 0 0 0 0 0 0 0 0 0 0 0 0 0 0 0 0 0 0 0 0 0 0 0 0 0 0 0 0 0 0 0 0 0 0 0 0 0 0 0 0 0 0 0 0 0 0 0 0 0 0 0 0 0 0 0 0 0 0 0 0 0 0 0 0 0 0 0 0 0 0 0 0 0 0 0 0 0 0 0 0 0 0 0 0 0 0 0 0 0 0 0 0 0 0 0 
0 0 0 0 0 0 0 0 0 0 0 0 0 0 0 0 0 0 0 0 0 0 0 0 0 0 0 0 0 0 0 0 0 0 0 0 0 0 0 0 0 0 0 0 0 0 0 0 0 0 0 0 0 0 0 0 0 0 0 0 0 0 0 0 0 0 0 0 0 0 0 0 0 0 0 0 0 0 0 0 0 0 0 0 0 0 0 0 0 0 0 0 0 0 0 0 0 0 
0 0 0 0 0 0 0 0 0 0 0 0 0 0 0 0 0 0 0 0 0 0 0 0 0 0 0 0 0 0 0 0 0 0 0 0 0 0 0 0 0 0 0 0 0 0 0 0 0 0 0 0 0 0 0 0 0 0 0 0 0 0 0 0 0 0 0 0 0 0 0 0 0 0 0 0 0 0 0 0 0 0 0 0 0 0 0 0 0 0 0 0 0 0 0 0 0 0 
30 29 0 0 0 0 0 0 0 0 0 0 0 0 0 0 0 0 0 0 0 0 0 0 0 0 0 0 0 0 0 0 0 0 0 0 30 29 0 0 0 0 0 0 0 0 0 0 0 0 0 0 0 0 0 0 0 0 0 0 0 0 0 0 0 0 0 0 0 0 0 0 0 0 0 0 0 0 0 0 0 0 0 0 0 0 0 0 0 0 0 0 0 0 0 0 0 0 
31 32 0 0 0 0 0 0 0 0 0 0 0 0 0 0 0 0 0 0 0 0 0 0 1 0 0 0 1 0 0 0 0 0 0 0 31 32 0 0 0 0 0 0 0 0 0 0 0 0 0 0 0 0 0 0 0 0 0 0 0 0 0 0 0 0 0 0 0 0 0 0 0 0 0 0 0 0 0 0 0 0 0 0 0 0 0 0 0 0 0 0 0 0 0 0 0 0 
31 32 0 0 0 0 0 0 0 0 0 0 0 0 0 0 0 0 0 0 0 0 0 0 41 0 0 0 41 0 0 0 1 0 0 0 31 25 29 0 0 0 0 0 0 0 0 0 0 0 0 0 0 0 0 0 0 0 0 0 0 0 0 0 0 0 0 0 0 0 0 0 0 0 0 0 0 0 0 0 0 0 0 0 0 0 0 0 0 0 0 0 0 0 0 0 0 0 
31 32 0 0 0 0 0 0 0 0 0 0 0 30 28 28 28 28 29 0 0 0 1 0 34 0 1 0 34 0 1 0 41 0 1 0 40 43 43 43 43 43 43 29 0 0 0 0 0 0 0 0 0 0 0 0 0 0 0 0 0 0 0 0 0 0 0 0 0 0 0 0 0 0 0 0 0 0 0 0 0 0 0 0 0 0 0 0 0 0 0 0 0 0 0 0 0 0 
31 32 2 2 2 2 2 2 2 2 2 2 30 24 27 27 27 27 32 0 0 0 41 0 34 0 41 0 34 0 41 0 34 0 41 0 0 11 11 11 11 11 11 34 0 0 0 0 0 0 0 0 0 0 0 0 0 0 0 0 0 0 0 0 0 0 0 0 0 0 0 0 0 0 0 0 0 0 0 0 0 0 0 0 0 0 0 0 0 0 0 0 0 0 0 0 0 0 
31 25 28 28 28 28 28 28 28 28 28 28 24 27 27 27 27 27 32 0 0 0 34 1 34 1 34 1 34 1 34 1 34 1 34 1 1 11 11 11 11 11 11 34 1 1 1 1 1 1 1 1 1 1 1 1 0 0 0 0 0 0 0 0 0 0 0 0 0 0 0 0 0 0 0 0 0 0 0 0 0 0 0 0 0 0 0 40 43 43 43 43 43 43 43 43 43 43 
31 27 38 38 38 27 27 37 37 37 27 27 37 37 37 27 27 27 32 0 0 0 30 28 28 28 28 28 28 28 28 28 28 28 28 28 28 29 11 11 11 11 11 25 28 28 28 28 28 28 28 28 28 28 28 29 0 0 0 0 0 0 0 0 0 0 0 0 0 0 0 0 0 0 0 0 0 0 0 0 0 0 0 0 0 0 0 0 11 11 11 11 11 11 11 11 11 31 
31 27 27 27 27 27 27 27 27 27 27 27 27 27 27 27 27 27 32 0 0 0 31 37 27 27 37 27 27 38 27 27 37 27 27 37 27 32 11 11 11 11 11 11 11 11 11 11 11 11 11 11 11 11 11 11 0 0 0 0 0 0 0 0 0 0 0 0 0 0 0 0 0 0 0 0 0 0 0 0 0 0 0 0 0 0 0 0 11 11 11 11 11 11 11 11 11 31 
31 27 37 37 37 27 27 37 37 37 27 27 38 38 38 27 27 27 32 0 0 0 31 27 27 27 27 27 27 27 27 27 27 27 27 27 27 32 11 11 11 11 11 11 11 11 11 11 11 11 11 11 11 11 11 11 0 0 0 0 0 0 0 0 0 0 0 0 0 0 0 0 0 0 0 0 0 0 0 0 0 0 0 0 0 0 0 0 11 11 11 11 11 11 11 11 11 31 
31 27 27 27 27 27 27 27 27 27 27 27 27 27 27 27 27 27 32 0 0 0 31 27 27 27 27 27 27 27 27 27 27 27 27 27 27 32 7 7 7 7 7 12 7 7 7 12 7 7 7 12 7 7 7 11 0 0 0 0 0 0 0 0 0 0 0 0 0 0 0 0 0 0 0 0 0 0 0 0 0 0 0 30 29 0 0 0 11 11 11 11 11 11 11 11 11 31 
31 27 37 37 37 27 27 38 38 38 27 27 37 37 37 27 27 27 32 0 0 0 31 37 27 27 38 27 27 37 27 27 37 27 27 38 27 32 7 7 7 7 7 11 7 7 7 11 7 7 7 11 7 7 7 11 0 0 0 0 0 0 0 0 0 0 0 0 0 0 0 0 0 0 0 0 0 0 0 0 0 30 0 0 0 0 0 0 11 11 11 11 11 11 11 11 11 31 
31 27 27 27 27 27 27 27 27 27 27 27 27 27 27 27 27 27 32 0 0 0 31 27 27 27 27 27 27 27 27 27 27 27 27 27 27 25 28 28 28 28 28 28 28 28 28 28 28 28 28 28 28 28 28 28 42 0 0 0 0 0 0 0 0 0 0 0 0 0 0 0 0 0 0 0 0 0 0 0 0 0 0 0 0 0 0 0 11 11 11 11 11 11 11 11 11 31 
31 27 27 27 27 27 27 27 27 27 27 27 27 27 27 27 27 27 32 0 0 0 31 27 27 27 27 27 27 27 27 27 27 27 27 27 27 27 27 27 27 27 27 27 27 27 27 27 27 27 27 27 27 27 27 32 0 0 0 0 0 0 0 0 0 0 0 0 0 0 0 0 0 0 0 0 0 0 0 30 0 0 0 0 0 0 0 0 11 12 11 12 11 12 11 12 8 31 
31 27 27 27 27 27 27 27 27 27 27 27 27 27 27 27 27 27 32 0 0 0 31 27 27 27 27 27 27 27 27 27 27 27 27 27 27 27 27 27 27 27 27 27 27 27 27 27 27 27 27 27 27 27 27 32 0 0 0 0 0 0 0 0 0 0 0 0 0 0 0 0 0 0 0 0 0 27 0 0 0 0 0 0 0 0 0 0 11 11 11 11 11 11 11 11 10 31 
31 27 27 27 27 27 27 27 27 27 27 27 27 27 27 27 27 27 32 0 0 0 31 27 27 27 27 27 27 27 27 27 27 27 27 27 27 27 27 27 27 27 27 27 27 27 27 27 27 27 27 27 27 27 27 32 0 0 0 0 0 0 0 0 0 0 0 0 0 0 0 0 0 0 0 0 0 0 0 0 0 0 0 0 0 0 0 30 28 28 28 28 28 28 28 28 28 24 
31 27 27 27 27 27 27 27 27 27 27 27 27 27 27 27 27 27 32 0 0 0 31 27 27 27 27 27 27 27 27 27 27 27 27 27 27 27 27 27 27 27 27 27 27 27 27 27 27 27 27 27 27 27 27 32 0 0 0 0 0 0 0 0 0 0 0 0 0 0 0 0 0 0 0 0 0 0 27 0 0 0 0 0 0 0 0 11 11 11 11 11 11 11 11 31 27 27 
31 27 27 27 27 27 27 27 27 27 27 27 27 27 27 27 27 27 32 0 0 0 31 27 27 27 27 27 27 27 27 27 27 27 27 27 27 27 27 27 27 27 27 27 27 27 27 27 27 27 27 27 27 27 27 32 0 0 0 0 0 0 0 0 0 0 0 0 0 0 0 0 0 0 0 0 0 0 0 0 27 0 0 0 0 0 0 11 11 11 11 11 11 11 11 31 27 27 
31 27 27 27 27 27 27 27 27 27 27 27 27 27 27 27 27 27 32 0 0 0 31 27 27 27 27 27 27 27 27 27 27 27 27 27 27 27 27 27 27 27 27 27 27 27 27 27 27 27 27 27 27 27 27 32 0 0 0 0 0 0 0 0 0 0 0 0 0 0 0 0 0 0 0 0 0 0 0 0 0 0 0 27 27 0 0 11 11 11 11 11 11 11 11 31 27 27 
31 27 27 27 27 27 27 27 27 27 27 27 27 27 27 27 27 27 32 0 0 0 31 27 27 27 27 27 27 27 27 27 27 27 27 27 27 27 27 27 27 27 27 27 27 27 27 27 27 27 27 27 27 27 27 32 0 0 0 0 0 0 0 30 29 0 0 0 0 0 0 0 0 0 0 0 0 0 0 0 0 0 0 0 0 0 30 29 11 11 11 11 11 11 11 31 27 27 
31 27 27 27 27 27 27 27 27 27 27 27 27 27 27 27 27 27 32 0 0 0 31 27 27 27 27 27 27 27 27 27 27 27 27 27 27 27 27 27 27 27 27 27 27 27 27 27 27 27 27 27 27 27 27 32 0 0 0 0 0 0 0 31 32 0 0 0 0 0 0 0 0 30 29 0 0 0 0 0 0 0 0 0 0 0 40 43 43 43 43 42 11 11 11 31 27 27 
31 27 27 27 27 27 27 27 27 27 27 27 27 27 27 27 27 27 32 0 0 0 11 11 11 12 11 11 11 12 11 11 11 12 11 11 11 12 11 11 11 12 11 11 11 12 11 11 11 12 11 11 11 12 11 11 0 0 0 0 0 0 30 24 25 29 0 0 41 0 0 0 0 31 32 0 0 0 0 0 0 0 0 0 0 0 0 11 11 11 11 11 11 11 30 24 27 27 
31 27 27 27 27 27 27 27 27 27 27 27 27 27 27 27 27 27 32 0 0 0 11 11 11 11 11 11 11 11 11 11 11 11 11 11 11 11 11 11 11 11 11 11 11 11 11 11 11 11 11 11 11 11 11 11 0 0 0 0 0 0 31 27 27 32 0 0 34 0 0 0 30 24 25 29 0 0 0 0 0 0 0 0 0 0 0 11 11 11 11 11 11 30 24 27 27 27 
27 27 27 27 27 27 27 27 27 27 27 27 27 27 27 27 27 27 27 27 27 27 27 27 27 27 27 27 27 27 27 27 27 27 27 27 27 27 27 27 27 27 27 27 27 27 27 27 27 27 27 27 27 27 27 32 0 0 0 0 0 30 24 27 27 25 29 0 34 0 0 0 31 32 0 0 0 0 0 0 0 0 0 0 0 0 0 11 11 11 11 11 30 24 27 27 27 27 
27 27 27 27 27 27 27 27 27 27 27 27 27 27 27 27 27 27 27 27 27 27 27 27 27 27 27 27 27 27 27 27 27 27 27 27 27 27 27 27 27 27 27 27 27 27 27 27 27 27 27 27 27 27 27 32 0 0 0 0 0 31 27 27 27 27 32 0 34 0 0 30 24 32 0 0 0 0 0 0 0 0 0 0 0 0 0 11 11 11 11 30 24 27 27 27 27 27 
27 27 27 27 27 27 27 27 27 27 27 27 27 27 27 27 27 27 27 27 27 27 27 27 27 27 27 27 27 27 27 27 27 27 27 27 27 27 27 27 27 27 27 27 27 27 27 27 27 27 27 27 27 27 27 25 28 28 28 28 28 27 27 27 27 27 25 28 24 28 28 24 27 25 28 28 28 28 28 28 28 28 28 28 28 28 28 28 28 28 28 24 27 27 27 27 27 27 
0 0 0 0 0 0 0 0 0 0 0 0 0 0 0 0 0 0 0 0 0 0 0 0 0 0 0 0 0 0 0 0 0 0 0 0 0 0 0 0 0 0 0 27 27 27 27 27 27 27 27 27 27 27 27 27 27 27 27 27 27 27 27 27 27 27 27 27 27 27 27 27 27 27 27 27 27 27 27 27 27 27 27 27 27 27 27 27 27 27 27 27 27 27 27 27 27 27 
0 0 0 0 0 0 0 0 0 0 0 0 0 0 0 0 0 0 0 0 0 0 0 0 0 0 0 0 0 0 0 0 0 0 0 0 0 0 0 0 0 0 0 27 27 27 27 27 27 27 27 27 27 27 27 27 27 27 27 27 27 27 27 27 27 27 27 27 27 27 27 27 27 27 27 27 27 27 27 27 27 27 27 27 27 27 27 27 27 27 27 27 27 27 27 27 27 27 
